RSI Signals for GBPUSD (1h timeframe):	Sell
RSI Signals for USDJPY (1h timeframe):	Hold
RSI Signals for AUDUSD (1h timeframe):	Hold
RSI Signals for USDCAD (1h timeframe):	Buy
RSI Signals for USDCHF (1h timeframe):	Buy
RSI Signals for NZDUSD (1h timeframe):	Hold
RSI Signals for EURJPY (1h timeframe):	Sell
RSI Signals for GBPJPY (1h timeframe):	Hold
RSI Signals for AUDJPY (1h timeframe):	Hold
RSI Signals for CADJPY (1h timeframe):	Hold
RSI Signals for NZDJPY (1h timeframe):	Hold
RSI Signals for GBPCHF (1h timeframe):	Hold
RSI Signals for GBPNZD (1h timeframe):	Hold
RSI Signals for GBPAUD (1h timeframe):	Hold
RSI Signals for GBPCAD (1h timeframe):	Hold
RSI Signals for AUDNZD (1h timeframe):	Hold
RSI Signals for AUDCAD (1h timeframe):	Hold
RSI Signals for AUDCHF (1h timeframe):	Hold
RSI Signals for CADCHF (1h timeframe):	Hold
RSI Signals for NZDCHF (1h timeframe):	Hold
RSI Signals for USDMXN (1h timeframe):	Hold
